13 13
+++++++++++++
+...........+
+.++.+++.++.+
+..+..+..+..+
+..+.....+..+
+..+..+..+..+
+.+++++++++.+
+..+..+..+..+
+..+.....+..+
+..+..+..+..+
+.++.+++.++.+
+...........+
+++++++++++++
1 1 2 1 3 1
6
Pillow 12
Food 3
Teleport 2